36 33 0 3
000000000000000000000000000000000000
000000000000000000000000000000000000
222222222000022222222222222222220000
222222232000023222222222222222320000
222222222000022222222222222222220000
000000222000022200000000000002220000
000000222000022200000000000002220000
000000222000022200000000000002222222
000000222000022200000000000002322223
000000222000022200001111000002222222
000000222000022200001111000000000000
000000222000022200001111000000000000
000000222000022200001111000000000000
000000222000022200000000000000000000
000000222000022200000000000000000000
000000222000022200000000000000000000
000000222000022200000000000000000000
000000222000022200000000000000000000
000000222000022200000000000000000000
000000222000022200000000000000000000
000000222000022200000000000000000000
000000222000022200000000000000000000
000000222011022200000000000000000000
000000222011022200000000000000000000
000000222000022200000000000000000000
000000222000022200000000000000000000
000000222011022200000000000000000000
000000222000022200000000000000000000
000000222222222200000000000000000000
000000232222223200000000000000000000
000000222222222200000000000000000000
000000000000000000000000000000000000
000000000000000000000000000000000000
