10 10 0 3
0000000000
0000000000
2222222222
3222222223
2222222222
0000000000
0011111110
0011000110
0011111110
0000000000